level1: [
'            ',
'            ',
'            ',
'    +       ',
'C   #  #    ',
'============',
'C   #+ #    ',
'    #- G    ',
'    P       ',
'    -       ',
'            ',
]
