{
	"blocks": [
		"            ",
		"            ",
		"            ",
		"    +       ",
		"A   #  #    ",
		"D   #+ #    ",
		"    #- G    ",
		"    P       ",
		"    -       ",
		"            "
	]
}
